2502 2502 2502 2502 2502 2502 2502 2502 2502 2502 2502 2502 2502 2502 2502 2502 2502 2502 2502 2502 2502 2502 2502 2502 2502 2502 2502 2502 2502 2502 2502 2502 2502 2502 2502 2502 2502 2502 2502 2502 2502 2502 2502 2502 2502 2502 2502 2502 2502 2502 
2502 2502 2502 2502 2502 2502 2502 2502 2502 2502 2502 2502 2502 2502 2502 2502 2502 2502 2502 2502 2502 2502 2502 2502 2502 2503 2503 2503 2503 2503 2503 2503 2503 2503 2503 2503 2503 2503 2503 2503 2503 2503 2503 2503 2503 2503 2503 2503 2503 2502 
2502 2502 2502 2502 2502 2502 2502 2502 2502 2502 2502 2503 2503 2503 2503 2503 2503 2503 2503 2503 2503 2503 2502 2502 2502 2503 2503 2503 2503 2502 2503 2503 2503 2503 2503 2503 2503 2503 2503 2503 2503 2503 2503 2503 2503 2503 2503 2503 2503 2502 
2502 2502 2502 2502 2502 2503 2503 2503 2503 2503 2503 2503 2502 2503 2503 2503 2502 2502 2502 2502 2502 2503 2502 2502 2502 2502 2502 2502 2502 2502 2503 2503 2503 2503 2503 2503 2503 2503 2503 2503 2503 2503 2503 2503 2503 2503 2503 2503 2503 2502 
2502 2502 2502 2502 2503 2503 2503 2502 2502 2502 2502 2503 2502 2503 2502 2503 2503 2503 2502 2502 2502 2503 2503 2503 2503 2502 2502 2502 2502 2502 2503 2503 2503 2503 2503 2503 2503 2503 2503 2503 2503 2503 2503 2503 2503 2503 2503 2503 2503 2502 
2502 2502 2502 2502 2502 2503 2503 2502 2502 2502 2502 2503 2503 2503 2503 2503 2502 2503 2503 2503 2502 2503 2502 2502 2503 2502 2502 2502 2502 2502 2503 2503 2503 2503 2503 2503 2503 2503 2503 2503 2503 2503 2503 2503 2503 2503 2503 2503 2503 2502 
2502 2502 2502 2502 2502 2503 2503 2502 2502 2502 2502 2503 2502 2503 2502 2502 2502 2502 2502 2503 2503 2503 2502 2502 2503 2503 2503 2503 2502 2502 2503 2503 2503 2503 2503 2503 2503 2503 2503 2503 2503 2503 2503 2503 2503 2503 2503 2503 2503 2502 
2502 2502 2502 2502 2503 2503 2503 2502 2502 2502 2502 2503 2503 2503 2503 2503 2503 2503 2503 2503 2503 2503 2502 2502 2503 2503 2503 2503 2502 2502 2503 2503 2503 2503 2503 2503 2503 2503 2503 2503 2503 2503 2503 2503 2503 2503 2503 2503 2503 2502 
2502 2503 2503 2503 2503 2503 2503 2502 2502 2502 2502 2502 2502 2502 2502 2503 2503 2503 2503 2502 2502 2502 2502 2502 2503 2503 2503 2503 2502 2502 2502 2502 2502 2502 2502 2502 2502 2503 2503 2503 2503 2503 2502 2502 2502 2502 2502 2502 2502 2502 
2502 2503 2503 2503 2503 2503 2503 2502 2502 2502 2502 2502 2502 2502 2502 2503 2503 2503 2503 2502 2502 2502 2502 2502 2503 2503 2503 2503 2502 2502 2502 2502 2502 2502 2502 2502 2502 2503 2502 2502 2502 2502 2502 2502 2502 2502 2502 2502 2502 2502 
2502 2503 2503 2502 2502 2502 2502 2502 2502 2502 2502 2502 2502 2502 2502 2503 2503 2503 2503 2502 2502 2502 2502 2502 2502 2502 2502 2502 2502 2502 2502 2502 2502 2502 2502 2502 2502 2503 2502 2502 2502 2502 2502 2503 2503 2503 2503 2503 2503 2502 
2502 2503 2503 2502 2502 2502 2502 2502 2502 2502 2502 2502 2502 2502 2502 2503 2503 2503 2503 2502 2502 2502 2502 2502 2502 2502 2502 2502 2502 2502 2502 2502 2502 2502 2502 2502 2502 2503 2502 2502 2502 2502 2503 2503 2503 2503 2503 2503 2503 2502 
2502 2503 2503 2502 2502 2502 2502 2502 2502 2502 2502 2502 2502 2502 2502 2503 2503 2503 2503 2503 2503 2503 2503 2503 2503 2503 2503 2503 2503 2503 2503 2502 2502 2502 2502 2502 2502 2503 2502 2502 2502 2502 2503 2503 2503 2503 2503 2503 2503 2502 
2502 2503 2502 2502 2502 2502 2502 2502 2502 2502 2502 2502 2502 2502 2502 2502 2502 2502 2502 2502 2502 2502 2503 2503 2503 2503 2503 2503 2503 2503 2503 2502 2502 2502 2502 2502 2502 2503 2502 2502 2502 2502 2503 2503 2503 2503 2503 2503 2503 2502 
2502 2503 2502 2502 2502 2502 2502 2502 2502 2502 2502 2502 2502 2502 2502 2502 2502 2502 2502 2502 2502 2502 2503 2503 2503 2503 2503 2503 2503 2503 2503 2502 2502 2502 2502 2502 2502 2503 2502 2502 2502 2502 2503 2503 2503 2503 2503 2503 2503 2502 
2502 2503 2502 2502 2502 2502 2502 2502 2502 2502 2502 2502 2502 2502 2502 2502 2502 2502 2502 2502 2502 2502 2503 2503 2503 2503 2503 2503 2503 2503 2503 2502 2502 2502 2502 2502 2502 2503 2502 2502 2502 2502 2503 2503 2503 2503 2503 2503 2503 2502 
2502 2503 2502 2502 2502 2503 2503 2503 2503 2503 2503 2503 2503 2503 2503 2503 2503 2503 2502 2502 2502 2502 2503 2503 2503 2503 2503 2503 2503 2503 2503 2503 2503 2503 2503 2503 2503 2503 2502 2502 2502 2502 2502 2502 2502 2502 2503 2502 2502 2502 
2502 2503 2502 2502 2502 2503 2503 2502 2502 2502 2502 2503 2502 2503 2502 2502 2503 2503 2502 2502 2502 2502 2502 2502 2502 2502 2502 2502 2502 2502 2502 2502 2502 2502 2502 2502 2502 2503 2502 2502 2502 2502 2502 2502 2502 2502 2503 2502 2502 2502 
2502 2503 2502 2502 2502 2503 2503 2502 2503 2502 2503 2503 2502 2503 2503 2502 2502 2503 2502 2502 2502 2502 2502 2502 2502 2502 2502 2502 2502 2502 2502 2502 2502 2502 2502 2502 2502 2503 2502 2502 2502 2502 2502 2502 2502 2502 2503 2502 2502 2502 
2502 2503 2502 2502 2502 2503 2503 2503 2503 2503 2503 2502 2502 2502 2503 2503 2502 2503 2502 2502 2502 2502 2502 2502 2502 2502 2502 2502 2502 2502 2502 2502 2502 2502 2502 2502 2502 2503 2503 2503 2503 2503 2503 2503 2503 2503 2503 2503 2502 2502 
2502 2503 2502 2502 2502 2503 2503 2503 2503 2503 2503 2503 2503 2503 2503 2503 2503 2503 2503 2502 2502 2502 2502 2502 2502 2502 2502 2502 2502 2502 2502 2502 2502 2502 2502 2502 2502 2503 2503 2502 2502 2502 2502 2502 2502 2502 2503 2503 2502 2502 
2502 2503 2502 2502 2502 2502 2502 2502 2502 2503 2502 2502 2502 2502 2502 2502 2502 2502 2503 2503 2502 2502 2502 2502 2502 2502 2502 2502 2502 2502 2502 2502 2502 2502 2502 2502 2502 2503 2503 2502 2502 2502 2502 2502 2502 2502 2503 2503 2502 2502 
2502 2503 2502 2502 2502 2502 2502 2502 2502 2503 2502 2502 2502 2502 2502 2502 2502 2502 2502 2503 2502 2502 2502 2502 2502 2502 2502 2502 2502 2502 2502 2502 2502 2502 2502 2502 2502 2503 2503 2502 2502 2502 2502 2502 2502 2502 2503 2503 2502 2502 
2502 2503 2502 2502 2502 2502 2502 2502 2502 2503 2502 2502 2502 2502 2502 2502 2502 2502 2502 2503 2503 2503 2503 2503 2503 2503 2503 2503 2502 2502 2502 2502 2502 2502 2503 2503 2503 2503 2503 2502 2502 2502 2502 2502 2502 2502 2503 2503 2502 2502 
2502 2503 2502 2502 2502 2502 2502 2502 2502 2503 2502 2502 2502 2502 2502 2502 2502 2502 2502 2502 2502 2502 2502 2502 2502 2502 2502 2503 2502 2502 2502 2502 2502 2502 2503 2503 2503 2503 2503 2502 2502 2502 2502 2502 2502 2502 2503 2503 2502 2502 
2502 2503 2502 2502 2502 2502 2502 2502 2502 2503 2502 2502 2502 2502 2502 2502 2502 2502 2502 2502 2502 2502 2502 2502 2502 2502 2502 2503 2502 2502 2502 2502 2502 2502 2502 2502 2502 2503 2503 2502 2502 2502 2502 2502 2502 2502 2503 2503 2502 2502 
2502 2503 2502 2502 2502 2502 2502 2502 2502 2503 2502 2502 2502 2502 2502 2502 2502 2502 2502 2502 2502 2502 2502 2502 2502 2502 2502 2503 2502 2502 2502 2502 2502 2502 2502 2502 2502 2503 2502 2502 2502 2502 2502 2502 2502 2502 2503 2503 2502 2502 
2502 2503 2502 2502 2503 2503 2503 2503 2503 2503 2503 2503 2502 2502 2502 2502 2502 2502 2502 2502 2502 2502 2502 2502 2502 2502 2502 2503 2502 2502 2502 2502 2502 2502 2502 2502 2502 2503 2502 2502 2502 2502 2502 2502 2502 2502 2503 2503 2502 2502 
2502 2503 2502 2503 2503 2502 2503 2502 2503 2503 2502 2503 2502 2502 2502 2502 2502 2502 2502 2502 2502 2502 2502 2502 2502 2502 2502 2503 2502 2502 2502 2502 2502 2502 2502 2502 2502 2503 2502 2502 2502 2502 2502 2502 2502 2502 2503 2503 2502 2502 
2502 2503 2503 2503 2503 2503 2503 2503 2503 2503 2503 2503 2503 2503 2503 2503 2503 2503 2503 2503 2503 2503 2503 2503 2503 2503 2503 2503 2502 2502 2502 2502 2502 2502 2502 2502 2502 2503 2502 2502 2502 2502 2502 2502 2502 2502 2503 2503 2502 2502 
2502 2502 2502 2502 2503 2503 2503 2503 2503 2503 2503 2503 2502 2502 2502 2502 2502 2503 2502 2502 2502 2502 2502 2502 2503 2502 2502 2502 2502 2502 2502 2502 2502 2502 2503 2503 2503 2503 2503 2503 2503 2503 2503 2503 2503 2503 2503 2503 2502 2502 
2502 2502 2502 2502 2503 2503 2503 2503 2503 2503 2503 2503 2502 2502 2502 2502 2502 2503 2502 2502 2502 2502 2502 2502 2503 2502 2502 2502 2502 2502 2502 2502 2502 2502 2503 2502 2502 2502 2502 2502 2502 2503 2503 2503 2503 2503 2503 2503 2502 2502 
2502 2502 2502 2502 2502 2502 2502 2502 2502 2502 2502 2502 2502 2502 2502 2502 2502 2503 2503 2503 2502 2502 2502 2502 2503 2502 2502 2502 2502 2502 2502 2502 2503 2503 2503 2502 2502 2502 2502 2502 2502 2503 2503 2503 2503 2503 2503 2503 2502 2502 
2502 2502 2502 2502 2502 2502 2502 2502 2502 2502 2502 2502 2502 2502 2502 2502 2502 2503 2503 2503 2502 2502 2502 2502 2503 2502 2502 2502 2502 2502 2502 2502 2503 2503 2503 2502 2502 2502 2502 2502 2502 2503 2503 2503 2503 2503 2503 2503 2502 2502 
2502 2502 2502 2502 2502 2502 2502 2502 2502 2502 2502 2502 2502 2502 2502 2502 2502 2503 2503 2503 2502 2502 2502 2502 2503 2502 2502 2502 2502 2503 2503 2503 2503 2503 2503 2503 2503 2503 2502 2502 2502 2503 2503 2503 2503 2503 2503 2503 2502 2502 
2502 2502 2502 2503 2503 2503 2503 2503 2503 2503 2503 2502 2502 2502 2502 2502 2502 2503 2503 2503 2502 2502 2502 2502 2503 2502 2502 2502 2502 2503 2503 2503 2503 2503 2503 2503 2503 2503 2502 2502 2502 2503 2503 2503 2503 2503 2503 2503 2502 2502 
2502 2502 2502 2503 2503 2503 2503 2503 2503 2503 2503 2502 2502 2502 2502 2502 2502 2503 2503 2503 2502 2502 2502 2502 2503 2503 2503 2503 2503 2503 2503 2503 2503 2503 2503 2503 2503 2503 2502 2502 2502 2502 2502 2502 2502 2502 2502 2502 2502 2502 
2502 2502 2502 2503 2503 2503 2503 2503 2503 2503 2503 2503 2503 2503 2503 2503 2503 2503 2503 2503 2502 2502 2502 2502 2502 2502 2502 2502 2502 2503 2503 2503 2503 2503 2503 2503 2503 2503 2502 2502 2502 2502 2502 2502 2502 2502 2502 2502 2502 2502 
2502 2502 2502 2503 2503 2503 2503 2503 2503 2503 2503 2502 2502 2502 2502 2502 2502 2502 2503 2503 2502 2502 2502 2502 2502 2502 2502 2502 2502 2503 2503 2503 2503 2503 2503 2503 2503 2503 2502 2502 2502 2502 2502 2502 2502 2502 2502 2502 2502 2502 
2502 2502 2502 2503 2503 2503 2503 2503 2503 2503 2503 2502 2502 2502 2502 2502 2502 2502 2503 2503 2502 2502 2502 2502 2502 2502 2502 2502 2502 2503 2503 2503 2503 2503 2503 2503 2503 2503 2502 2502 2502 2502 2502 2502 2502 2502 2502 2502 2502 2502 
2502 2502 2502 2502 2503 2503 2503 2503 2503 2503 2503 2502 2502 2502 2502 2502 2502 2502 2503 2503 2502 2502 2502 2502 2502 2502 2502 2502 2502 2502 2502 2502 2503 2503 2502 2502 2502 2502 2502 2502 2502 2502 2502 2502 2502 2502 2502 2502 2502 2502 
2502 2502 2502 2502 2502 2503 2502 2502 2503 2502 2502 2502 2502 2502 2502 2502 2502 2502 2503 2503 2502 2502 2502 2502 2502 2502 2502 2502 2502 2502 2502 2502 2503 2503 2502 2502 2502 2502 2502 2502 2502 2502 2502 2502 2502 2502 2502 2502 2502 2502 
2502 2502 2502 2502 2502 2503 2502 2502 2503 2502 2502 2502 2502 2502 2502 2503 2503 2503 2503 2503 2503 2503 2503 2502 2502 2502 2502 2502 2502 2502 2502 2502 2503 2503 2502 2502 2502 2502 2502 2502 2503 2503 2503 2503 2503 2503 2503 2503 2503 2502 
2502 2502 2502 2502 2502 2503 2502 2502 2503 2502 2502 2502 2502 2502 2503 2503 2503 2503 2503 2503 2503 2503 2503 2502 2502 2502 2502 2502 2502 2502 2502 2502 2503 2503 2502 2502 2502 2502 2502 2502 2503 2503 2503 2503 2503 2503 2503 2503 2503 2502 
2502 2502 2503 2503 2503 2503 2502 2502 2503 2502 2502 2502 2502 2502 2503 2503 2503 2503 2503 2503 2503 2503 2503 2502 2502 2502 2502 2502 2502 2502 2502 2502 2503 2503 2502 2502 2502 2502 2502 2502 2503 2503 2503 2503 2503 2503 2503 2503 2503 2502 
2502 2502 2503 2503 2503 2503 2502 2502 2503 2502 2502 2502 2502 2502 2503 2503 2503 2503 2503 2503 2503 2503 2503 2503 2503 2503 2503 2503 2503 2503 2503 2503 2503 2503 2503 2503 2503 2503 2503 2503 2503 2503 2503 2503 2503 2503 2503 2503 2503 2502 
2502 2502 2503 2503 2503 2503 2503 2502 2503 2503 2503 2503 2503 2503 2503 2503 2503 2503 2503 2503 2503 2503 2503 2503 2503 2503 2503 2503 2503 2503 2503 2503 2503 2503 2503 2503 2503 2503 2503 2503 2503 2503 2503 2503 2503 2503 2503 2503 2503 2502 
2502 2502 2503 2503 2503 2503 2503 2502 2502 2502 2502 2502 2502 2502 2503 2503 2503 2503 2503 2503 2503 2503 2503 2502 2502 2502 2502 2502 2502 2502 2502 2502 2503 2503 2502 2502 2502 2502 2502 2502 2503 2503 2503 2503 2503 2503 2503 2503 2503 2502 
2502 2502 2502 2502 2502 2502 2502 2502 2502 2502 2502 2502 2502 2502 2503 2503 2503 2503 2503 2503 2503 2503 2503 2502 2502 2502 2502 2502 2502 2502 2502 2502 2503 2503 2502 2502 2502 2502 2502 2502 2503 2503 2503 2503 2503 2503 2503 2503 2503 2502 
2502 2502 2502 2502 2502 2502 2502 2502 2502 2502 2502 2502 2502 2502 2502 2502 2502 2502 2502 2502 2502 2502 2502 2502 2502 2502 2502 2502 2502 2502 2502 2502 2502 2502 2502 2502 2502 2502 2502 2502 2502 2502 2502 2502 2502 2502 2502 2502 2502 2502 
