0 1 2 3 4 0 6 7 8 9 10 11 12 13 14 15 16 17 18 19 20 21 22 23 24 25 26 27 28 29 30 31 32 33 34 35 36 37 38 39 40 41 42 43 44 45 46 47 48 49 
50 51 52 53 54 55 0 0 0 59 60 0 62 63 64 65 66 67 68 69 70 71 72 73 74 75 76 77 78 79 80 81 81 81 81 81 86 87 88 89 90 90 90 90 94 95 96 97 97 97 
100 101 102 103 0 0 106 0 0 0 0 111 112 113 114 115 116 117 118 119 0 0 0 123 124 125 126 127 128 0 0 131 131 131 131 131 0 0 0 0 0 141 141 141 144 145 146 147 115 149 
150 0 0 153 154 155 0 157 158 159 160 160 0 163 164 165 166 167 168 169 170 171 0 173 174 0 0 0 0 0 0 0 0 0 0 0 0 0 188 0 0 191 191 191 0 195 196 197 198 199 
200 201 0 203 204 0 206 207 208 209 210 0 0 213 214 215 216 218 218 219 220 221 222 0 0 0 0 0 228 0 0 0 0 233 0 0 0 0 0 0 0 0 0 0 244 245 245 247 248 249 
250 251 0 0 0 0 256 257 258 259 260 0 0 263 264 265 266 267 268 269 270 271 0 0 0 0 0 0 0 283 0 0 0 0 284 0 0 0 0 0 0 0 0 0 294 294 294 294 298 299 
300 301 302 0 0 305 0 0 0 0 310 311 312 0 0 315 316 317 318 319 320 321 0 0 0 0 0 0 0 0 0 0 0 0 0 335 336 0 0 0 340 0 0 0 344 345 346 347 348 349 
350 351 0 0 354 355 0 0 0 0 360 361 362 0 364 365 366 367 367 369 370 371 372 0 0 0 0 377 378 0 0 381 0 0 0 385 386 0 0 0 0 0 0 0 394 395 396 397 398 399 
400 401 0 0 0 405 0 0 0 0 410 0 0 413 414 415 416 417 418 419 420 421 0 0 0 0 0 0 0 0 0 0 0 0 0 0 0 0 0 0 440 0 0 0 0 0 0 0 463 449 
450 451 0 0 0 455 0 0 0 0 460 0 0 463 464 465 466 467 468 469 470 0 472 0 0 475 0 0 0 0 0 0 0 483 0 0 0 0 0 0 0 0 0 0 0 0 0 0 498 499 
500 501 502 503 503 503 0 0 0 0 510 510 510 513 514 515 516 517 518 520 0 0 0 523 0 0 0 0 0 0 0 0 0 0 0 0 0 537 0 0 0 0 0 0 0 545 0 0 548 549 
550 551 0 0 0 0 0 0 0 0 0 0 562 563 564 565 566 567 568 569 570 571 0 573 0 0 0 0 0 0 0 0 0 0 0 0 0 0 0 0 0 0 592 593 0 595 0 0 598 599 
600 601 602 0 0 0 0 0 0 0 0 0 612 0 614 615 616 617 618 619 620 621 622 0 0 0 0 627 0 0 0 0 0 0 0 0 0 0 638 0 0 0 642 643 0 645 0 0 648 649 
650 651 0 0 0 0 0 0 0 0 660 661 0 663 664 665 666 667 668 669 670 671 672 673 674 675 676 677 678 679 680 680 682 683 684 0 0 0 0 0 690 0 0 0 0 0 0 697 698 699 
700 701 702 703 0 705 706 707 708 0 710 711 712 713 714 715 716 717 718 719 720 721 722 723 724 725 726 727 728 729 730 731 732 733 734 0 736 0 0 0 740 0 0 0 0 0 0 747 748 749 
750 751 752 753 0 755 756 756 758 0 0 0 762 763 764 765 0 767 768 769 770 771 772 773 774 775 776 777 778 779 780 781 782 783 784 785 0 0 0 0 790 0 0 793 794 795 795 797 798 799 
800 801 0 0 0 805 806 806 808 0 0 0 0 0 0 0 0 0 818 819 820 821 822 822 822 822 826 827 828 828 828 831 832 833 834 835 836 0 0 0 0 841 842 843 844 845 846 847 848 849 
850 851 0 853 854 855 856 857 858 0 0 0 0 0 0 865 0 0 0 869 870 870 870 870 870 875 876 876 878 879 880 881 882 883 884 885 886 887 888 0 890 891 892 893 894 894 896 897 898 899 
900 901 902 903 904 905 906 907 908 0 910 0 0 0 0 0 916 0 0 0 0 0 0 923 924 925 926 927 928 929 930 931 932 933 934 935 936 937 938 939 940 941 942 943 944 945 946 947 948 949 
950 951 0 0 0 955 956 956 958 0 0 0 962 0 0 0 0 0 0 0 0 971 972 0 974 975 976 976 978 979 0 981 982 983 984 985 986 987 988 989 990 991 992 993 994 995 996 997 998 998 
1000 1001 0 0 0 1005 1006 1007 1008 0 0 0 0 0 0 0 0 0 0 0 0 1021 1022 0 1024 1025 1026 1027 1027 1029 1030 0 1032 1033 1034 1035 1036 1037 1038 1039 1040 1041 1041 1043 1044 1044 1046 1089 1089 1089 
1050 1051 0 0 0 1055 1056 1057 1058 0 0 0 0 1065 1064 0 0 0 0 1069 0 0 0 0 1074 1075 1075 1075 1075 1079 0 1081 1082 1083 1084 1085 1086 1087 1087 1087 1090 1091 1092 1093 0 0 1096 1098 1098 1099 
1100 1101 0 1103 0 1105 1106 1107 1108 0 0 1111 1111 0 0 0 0 0 0 0 1120 0 0 0 1174 1125 1125 1127 1125 1179 0 1131 1132 0 1134 1135 1136 1137 1138 1139 1140 1141 1142 1143 1144 1145 1146 1147 1148 1149 
1150 1151 0 0 0 1155 1156 1157 1158 1159 1160 1161 0 0 0 1165 0 0 0 0 0 1171 0 0 1174 1156 1156 1177 1177 1179 0 0 0 1183 0 1185 1186 1187 1188 1189 1190 1191 0 1193 0 1195 1196 1197 1198 1199 
1200 1201 1202 1203 0 1205 1206 1207 1208 1209 1210 1210 1210 1210 1210 1210 1210 1210 1210 1210 1210 1210 1210 1210 1224 1225 1225 1225 1225 1229 1230 1230 1230 1230 1230 1230 1230 1230 1230 1230 1230 1230 1230 1230 1230 1230 1246 1247 1248 1249 
1250 1251 1252 1253 0 1255 1256 1256 1256 1256 1256 1256 1262 1263 1263 1263 1263 1263 1263 1263 1270 1271 1271 1271 1271 1271 1271 1277 1278 1278 1278 1278 1278 1278 1278 1278 1278 1287 1288 1288 1288 1288 1288 1288 1288 1295 1296 1297 1298 1299 
1300 1301 1302 1302 0 1305 1306 1307 1307 1307 1307 1307 1307 1307 1307 1307 1307 1307 1307 1307 1307 1307 1307 1307 1324 1307 1307 1307 1307 1307 1307 1331 1307 1307 1307 1307 1307 1307 1307 1307 1307 1307 1342 1307 1307 1307 1346 1347 1348 1349 
1350 1351 1352 1353 0 1355 1356 1356 1356 1356 1356 1356 1356 1356 1364 1365 1366 1367 1368 1368 1368 1368 1368 1368 1368 1368 1368 1368 1368 1368 1368 1368 1368 1368 1384 1385 1385 1387 1388 1388 1388 1388 1388 1388 1388 1388 1396 1397 1398 1399 
1400 1401 1402 0 0 0 0 0 0 0 0 0 0 0 1414 1415 1415 1417 1418 1419 0 0 0 0 1424 0 1426 0 0 0 0 0 0 0 1434 1435 1435 1437 1438 1439 1440 1440 1440 1440 1440 1440 1446 1447 1448 1449 
1450 1451 0 0 1454 0 0 0 1458 0 0 0 0 0 1464 1465 1465 1467 1468 1469 0 0 0 0 1474 0 0 0 1478 0 0 0 1482 1483 1484 1485 1485 1487 1488 1489 1490 1490 1490 1490 1495 1495 1496 1497 1498 1499 
1500 1501 0 0 0 0 0 0 0 0 0 0 1512 0 1514 1515 1516 1517 0 0 1520 0 0 0 1524 0 0 0 0 0 0 0 1532 1533 1534 1535 1535 1537 1538 1539 1540 1540 1542 1543 1543 1543 1546 1547 1548 1549 
1550 1551 0 0 0 0 0 1557 1558 0 0 0 0 1563 1564 1565 1565 1567 1568 0 0 0 1572 0 0 0 0 0 0 0 0 0 0 0 1584 1585 1585 1587 1588 1589 1589 1591 1592 1593 1594 1595 1595 1595 1595 1595 
1600 1601 0 1603 0 0 1606 1607 1608 1609 0 0 0 0 1614 1615 1616 1617 1618 1618 1618 1618 1618 1618 1618 1618 1626 1626 1626 1629 1629 1631 1632 1632 1634 1635 1636 1587 0 0 0 1641 1642 1643 1644 1645 1646 1646 1646 1646 
1650 1651 0 0 0 0 1656 1657 1658 1659 0 0 0 1663 1664 1665 1665 1665 1665 1665 1665 1671 1672 1672 1672 1672 1672 1677 1677 1675 1675 1675 1681 1675 1675 1685 1668 1687 1688 1689 0 0 0 1693 1694 1695 1696 1697 1696 1696 
1700 1701 1702 1703 1704 0 0 0 0 1709 1710 0 0 1713 1714 1715 1715 1715 1718 1719 1719 1719 1719 1719 1719 1725 1726 1726 1726 1726 1726 1726 1726 1726 1726 1735 1736 1737 1738 1739 0 0 0 0 1744 1745 1746 1746 1746 1746 
1750 1751 0 1753 0 0 0 0 0 1759 1760 0 0 0 1764 1765 1765 1765 1765 1770 1771 1772 1773 1774 1775 1776 1777 1778 1779 1780 1781 1781 1781 1781 1781 1781 1781 1787 0 0 0 1791 1792 1792 1792 1795 1796 1797 1798 1797 
1800 1801 0 1803 0 1805 0 0 0 0 0 0 0 0 1814 1814 1814 0 0 1820 1821 1822 0 1824 1825 1826 1827 1828 1829 1830 0 0 1833 1833 1833 0 0 1838 0 0 0 1841 0 0 1844 1845 1846 1847 1847 1847 
1850 1851 0 0 0 0 0 0 0 0 0 0 0 0 0 0 0 0 0 1870 1871 1872 1873 0 1875 0 0 0 0 0 0 0 0 0 0 0 0 0 0 0 0 1891 0 0 0 1895 1896 1897 1898 1898 
1900 1901 0 1903 1903 1903 1903 1903 1903 1903 1903 1911 1911 1911 1911 1911 1911 1911 1911 1920 1921 1922 1923 1923 1923 1923 1923 1923 1923 1923 1923 1923 1923 1923 1923 1923 1923 1923 1923 1923 1923 1941 0 0 1944 1945 1946 1947 1948 1948 
1950 1951 1952 1952 1952 1952 1952 1952 1952 1952 1952 1961 1962 1963 1964 1965 1966 0 0 0 0 0 1973 1974 0 1976 1977 0 1979 1980 0 1983 1984 0 0 0 0 0 0 0 0 0 0 0 0 0 1996 1997 1998 1998 
2000 2001 2002 2002 2002 2002 2002 2002 2002 2002 2002 2011 2012 2013 2014 2015 2016 0 0 0 0 0 2023 2024 0 2026 2027 0 2029 2030 0 2033 2034 0 0 0 0 0 0 0 2040 2041 2042 2043 2044 0 2046 2047 2048 2049 
2050 2051 2052 2052 2052 2052 2052 2052 2052 2052 2052 2061 2062 2063 0 0 0 0 0 0 0 0 0 0 0 0 0 0 0 0 0 0 0 0 0 0 0 0 0 0 2090 2091 2092 2093 2094 2095 2096 2097 2098 2099 
2100 2101 2102 0 0 2105 2106 2107 2108 2109 2110 2111 0 0 0 0 0 0 0 0 0 0 0 0 0 0 0 0 0 0 0 0 0 0 0 0 0 0 0 0 0 0 2142 2143 2144 2145 2146 2147 2148 2149 
2150 2151 2152 0 0 2155 2156 2157 2158 2159 2160 2161 0 0 0 0 0 0 0 0 0 0 0 0 0 0 0 0 0 0 0 0 0 0 0 0 0 0 0 0 0 0 0 0 0 2195 2196 2197 2198 2199 
2200 2201 2202 0 0 0 0 0 0 0 0 0 0 0 0 0 0 2217 2218 2218 2220 0 2222 2223 2224 2224 2226 0 2228 2229 2229 2229 2229 2233 0 0 0 0 0 0 0 0 0 0 0 2245 2246 2247 2248 2249 
2250 2251 0 0 0 2255 0 0 0 0 0 0 2262 0 0 0 0 2267 2268 2268 2268 2268 2268 2273 0 0 0 2277 0 0 2280 2280 2280 2283 0 0 0 0 0 0 0 0 0 0 0 0 2296 2297 2298 2299 
2300 2301 0 0 0 0 0 0 0 0 0 0 2312 0 0 0 0 2317 2318 2318 2318 2318 2318 2323 0 0 0 0 0 0 0 2331 0 2333 0 0 0 0 0 0 0 0 0 0 0 0 2346 2347 2348 2349 
2350 2351 0 2353 0 0 0 0 0 0 0 0 0 0 0 0 0 2367 2368 2368 2368 2368 2368 2373 0 2375 0 0 0 0 0 0 0 2383 0 2385 2389 2390 2388 2389 2390 0 0 0 0 0 2396 2397 2398 2399 
2400 2401 2402 2403 2404 2405 2406 2407 2408 2409 2410 2411 2412 2413 2414 2415 2416 2417 2418 2419 2420 2421 2422 2423 2424 2425 2426 2427 2428 2429 2430 2431 2432 2433 2434 2435 2436 2437 2437 2439 2440 2440 2440 2440 2444 2444 2444 2447 2448 2449 
2450 2451 2452 2453 2454 2455 2456 2457 2458 2459 2460 2461 2462 2463 2464 2465 2466 2467 2468 2469 2470 2471 2470 2473 2470 2473 2474 2475 2476 2477 2480 2481 2482 2483 2484 2485 2486 2487 2488 2486 2490 2490 2490 2490 2494 2495 2495 2495 2498 2499 
